........................................................................................................................
........................................................................................................................
........................................................................................................................
........................................................................................................................
........................................................................................................................
.....................................###########################........................................................
................................###.....................................................................................
........................................................................................................................
..........................###...........................................................................................
........................................................................................................................
....................###.................................................................................................
........................................................................................................................
...............###......................................................................................................
........................................................................................................................
.........###............................................................................................................
........................................................................................................................
........................................................................................................................
....###.......###.......................................................................................................
.........#######....................#...................................................................................
.1.......#..........................#..................................................................................X
########################################################################################################################
