........................................................................................................................
........................................................................................................................
........................................................................................................................
........................................................................................................................
........................................................................................................................
.....................................---------------------------........................................................
................................---.....................................................................................
........................................................................................................................
..........................---...........................................................................................
........................................................................................................................
....................---.................................................................................................
........................................................................................................................
...............---......................................................................................................
........................................................................................................................
.........---............................................................................................................
........................................................................................................................
........................................................................................................................
....###.......###.......................................................................................................
....-....#######....................-...................................................................................
.1..-....#..........................-..................................................................................X
------------------------------------------------------------------------------------------------------------------------
